    NO ./src/texture/n.xpm

    SO ./src/texture/s.xpm
WE./src/texture/w.xpm
EA    ./src/texture/e.xpm

  F 250,    100,   0
C 225   ,   30,   0


            11111111111111111111111
           1000000000110000000000001
           1011000001110000000000001
           1001000000000000000000001
11111111111100000111000000000000111
10000000001100000111011111111111
11110111111111011100000000001
11110111111111011101010010001
11000000110101011100000010001
10000000000000001100000010001
10000000000000001101010010001
1100000111010101  11011110N0111
11110111 1110101 100000010001
11111111 1111111 111111111111
